11111111111111
10000001010001
10000000000001
10000100000001
1010PC000C1001
1010101011E111
11111111111111