11111111111
1P0C0000001
10000000001
11111111111