111111111
1P0C00001111
1000000011111
1111111111111111