111111111
1P0C00E01
100P00001
111111111